******************************
******************************
******************************
***......*................X***
***.****.*.*******************
***.*....*......**************
***.*******.***.**************
***.....***.....*...**********
*****.*********.*.*....*...***
***.*.*...*.....*.****...*****
***.*.*.*.*.*****....*********
***.*.*.*.*.....****.*.....***
***.*.*.*.*****.****.*.*...***
***.....*.*.......**...*...***
****.****.*.*****.********.***
***...*...*.....*.*........***
***...*.*******.*.*.**********
***.***.***.....*.*.***....***
***...*.***.*****.*.....**.***
***...*.***.....*.******...***
***...*.*.*****.*........*****
****.**.*.......**********.***
****..*.*.*****.********...***
*****.*................*.*.***
***...*.**************.*.*.***
***.**..*..................***
***..*.********.**********.***
*****.....***..........***.***
***...***.....********.*...***
***...***.****.....*...*...***
***.......*....***...*.....***
***********.**...*************
***.......*.**...*.........***
***.*****.*.**...*.*******.***
***.....*.*.***.**.*.......***
*******.*.**.....*.*.*********
***...*.*.**.***.*.*.*.....***
***.*.*.*........*.*.*.*...***
***...*.*****.****.*...*...***
****.**.*........*.******.****
***...*...******...........***
***...***.......******.*******
***.......*******.........****
*******.*.*.......*******.****
***...*.*.*******.......*..***
***.*...*......@*******.******
***.*****************......***
***.*...*...*...*...*.***.****
***...*...*...*...*...*....***
******************************
******************************
******************************

